[[98,1,1,1,1,1,1,98,98,1,1,1,98,98,98,98,1,1,1,1],
[98,1,1,1,1,1,98,98,98,1,1,1,98,98,98,98,1,1,1,1],
[98,98,1,1,1,98,98,98,98,1,1,1,1,1,1,1,1,1,1,1],
[98,98,1,1,1,98,1,1,98,1,1,1,1,98,1,1,1,98,1,98],
[98,98,98,98,98,98,1,1,98,98,1,1,1,98,1,1,1,98,1,98],
[98,98,98,98,98,98,1,1,98,98,1,98,98,98,1,1,1,98,1,98],
[1,1,1,1,1,1,1,1,98,98,1,98,98,98,98,98,98,98,1,98],
[98,98,98,98,98,98,98,1,1,1,1,98,98,1,1,1,1,1,1,98],
[98,98,98,98,98,98,98,98,98,98,98,98,98,1,98,98,98,98,98,98],
[1,1,1,1,1,1,1,1,1,1,1,98,98,1,98,98,98,98,98,98],
[1,1,98,98,1,1,98,98,1,1,1,98,98,1,1,1,1,1,1,98],
[1,1,1,1,1,1,1,1,1,98,1,98,98,98,98,98,98,98,1,98],
[98,98,98,98,98,98,98,98,98,98,1,1,1,1,1,1,1,1,1,98]]
